1111111111111
1000000000001
100000C000011
1000000000C01
1E000C00010P1
1111111111111