1111111
1PCE101
1000101
1000101
1111111