111111111111111111111111111111111111111111111111111111111111111111111111111111111111111111111111111
1000000000000000000000000000000000000000000000000000000000000000000000000000000000000000000000000P1
100000000000000000000000000000000000000000000000000000C0000000000000C111111111111111111111111111111
1000000000000000000000000000000000000000C000000000000000000000000001111C000000110110110110110110111
1000000000000000000000000000000000000000C0000000000000000000000000011111111000010010010010010010011
100000000000000000000000000000000000000000000000000000000000000000000000000000010010010010010010011
100000000000000000000000000000000000000000000000000000000000000000000000000000010010010010010010011
10000000000000000000000000000C000000000000000000000000000000000000000000000000010010010010010010011
10000C0000000000000000000000000000000000000000000000000000000000000000000E0000010010010010010010011
111111111111111111111111111111111111111111111111111111111111111111111111111111111111111111111111111