1111111111111
1000000000001
100000C000011
1E000C00B10P1
1111111111111